1111111111111111111111111111111111
1E0000000000000C00000C000000000001
1010010100100000101001000000010101
1010010010101010001001000000000111
1P0000000C00C000000000000001000001
100000000000000C00000C000000000001
1010010100100000101001000000010101
1010010010101010001001000001010111
100000000C00C000000100000001000001
1111111111111111111111111111111111
