1111111111111
1P00000000CE1
1111111111111
