111111111111111111111111111111111111
10P000000100000000000000000000100001
10000000010000000000000000000000E001
100000000000000000000C00000000111111
100000000100000000000000000000000001
100000000100000000000000000000000001
100000000100000000000000000000000001
100000000100000000000000000000000001
1000000001000000000000000C0000000001
100000000100000000000000000000000001
1000000001000000000000C0000000000001
100000000100000010000000000000000001
100000000000000000C00000000000000001
100000000100000000000000000000000001
111111111111111111111111111111111111
